                                        
                 ###########            
                 #:::##::::#            
      ########   #:::#####=#####        
      #::::::#   #:::##::::::::# ###### 
#######=##########:::##=######=###::::# 
#::::::::=::::::##:::=:::::::::::=::::# 
##########:##=#=##:::#############::::# 
      #::::::::::::::#    #####  #::::# 
   #############:#:########:::#  #::::# 
   #:#         #:=:::::::##:#=######:## 
   #:######### #:#:::::::=::::::# #:::# 
   #:::::::::# #:#:::::::#::::=:# #:::# 
####=#=#####:###::::::::::::::#:# #:::# 
#::::::::::=:::#:#:::::::#::::#:# #:::# 
###=########:::#:#:::@:::=::::=:# #:::#
 #:::=::::##:::=:::::::::######## #:::# 
 #:::#::::##:::#:#:::::::#  #######:::# 
 #:::#::::##:::#:#:::::::#  #:::::##### 
 #:::#######:::=:##=####=####::##:#     
 #:::#     #:::::#::::##::::::::#:#     
 #:::########:##:#::::##::::::::#:#     
 #::::::::::::##:#::::##::::::::=:#     
 #####:#########::::::##::::::::###     
 #:::::#       #:#::::##::::::::#       
 #=#=######### #:#::::##::::::::#       
 #:::::::::::# #:#::::#######:######    
 ####=##=##### #:#::::#     #::::::#    
    #::::#     ########     ########    
    ######                              
