                           #######                ##################  
                           #:::::#          ##### #::::::::::=:::::#  
                           #####:########   #:=:# ##########=##=####  
                             #::::::::::#   #:#:###   #:#  #:#:::::#  
                             ##########:#   #:#:=:#   #:#  #:#:::::#  
                                      #:#   #:#:#:#   #:#  #:#:::::#  
                                      #:#   #:#:#:#   #:#  #:#:::::#  
                   ###############    #:#   #:#:#:#   #:#  #:#:::::#  
                   #:::::::::::::#  ###:#   #:#:=:#   #:#  #:=:::::#  
      ##########################=## #:::#   #:#:#:### #:#  #:#=#####  
      #::::::::::::::###:::=::::::# #:#:#   #:#:=:=:# #:#  #:#:::::#  
      ##############=#:###:#:####=# #:#:#   #:#:#:#:# #:#  #:#:#:::#  
       #:::::::::::::=:=::::::::::# #:#=#   #:#:###:###:#  #:#:#:::#  
      ################:############ #:#:#   #:=:# #:#:::#  #:#:::::#  
      #::::::#       #:#            #:#:#   ###:# #:#:#:#  #:=:#:#:#  
############:#########=##############:#:#     #:# #:#:::####=#:#:::#  
#:::::::::::::::::::::::::::::::::::=:#:#     #:# #####:=::::=:#####  
#######:#############:#############=###=#######:#########==#=#####    
      #:#   #::::::::::###      #:::::::::::=::::::::##::::::::::#    
      #:#   #::::::::::=:#  ############:=###=##=#########:#:###=#### 
      #:#   #::::::::::#:#  #:::::::::::::##:::::::::::::::::# #::::# 
      #:#   #::::::::::#:#  ###########################:###:####=##=# 
      #:#   #::::::::::#:#             #::::::::::::::::# #:#:::::::# 
      #:#   #::::::::::#:######################=###########:=:::::::# 
      #:#   #::::::::::#:=:::::::::::::::# #::::#  #::::::=:#:::::::# 
      #:#   ##########=#:####=##########=###=#######:####=#:::::::::# 
      #:#        #:::::#:#  #::::::# ###:=::::::::::::::::=:=:::::::# 
      #:#        #:::::#:#  #::::::# #:=:##:#####:=########:#:::::::# 
      #:#        #:::::#:#  #::::::# #:#:##::::::::#    ###:#:###:### 
      ###        #:::::#:#  #::::::# #:#:###########    #:=:=:::::#   
                 #:::::#:#  #::::::# #:#:#  ########### #:#:#:#####   
                 #:::::#:#  #::::::# #:###  #:::::::::# #:#:#:#       
                 #:::::#:#  #::::::# #:##############:#####=#:#       
                 #:::::#:#  ######## #::::::::::##::::::::::#:#       
   #######       #:::::#:#           #############::::::::::#:#       
   #:::::#       #######:#                       #::::::::::#:#       
   #####:###############:#                       #::::::::::###       
       #:::::::::::::::::#                       ############         
       ###################                                            
                                                                      
