             #######################################################  
             #:::::::::::::::::::::::::::::::::::::::::::::::::::::#  
     ###########:##=##########################:#:=##################  
     #::::::::::::::#      #############    #::::::::###::::::::::#   
     ###=############      #:::::::::::#    #::::::::::#::::::::::#   
       #:#    ##############:########==######::::::::#:#::::::::::#   
       #:#    #:=:::::::::::::::::::::::::::#::::::::=:=::::::::::#   
       #:#  ###:###=############=####:::::::=::::::::#=#::::::::::#   
       #:#  #:::###:::### #::::::#  #::::::::::::::::#:=::::::::::#   
       #:#  #:#:=:::::=:###::::::#  #::::::::::::::::#::::::::::::#   
       ###  #:::#:#:::#:#:#::::::#####:###=:#::::::::::#::::::::::#   
            #:::#:::::#:::#::::::=::::::=:::#::::::::###::::::::::#   
            ###:###:::#:#:#::::::#::::::##=##:#####:####::::::::::#   
              #:###:::#:#:#::::::#::::::##::::###:::::###:##:######   
         ######=#:=:::#:#::::::::=::::::##::::::::::::#:::::::::#     
       ###:=::::#:#:::#:###::::::#::::::##::::#:#:::::#:::::::::#     
       #:=:#::::#:#:::#:# #::::::#::::::##::::=:#:::::=:::::::::#     
       #:#:#::::#:#:::=:# ####=###::::::##::::#:::::::#:::::::::#     
       #:#:#::::#:#######    #:# #::::::##::::###=######=###=##=###   
       #:#:#::::#=#     ###  #:# #::::::##::::# #::::::::::::##:::#   
       #:#:#::::::#     #:#  #:# ###:#:#####=########::::::::##:::#   
       ###:###:##:#     #:#  #:# #:::::##::::::::#  #::::::::##:::#   
         #:# #:##:#     #:#  #:# #:::::##::::::::#  #::::::::##:::#   
        ##:###:##:#     #:#  #:# #:::::##::::::::#  #::::::::##:::#   
        #::::#:##:# #####:#  #:# #:::::##::::::::#  #::::::::##:::#   
        #::::#:##:# #:::#:#  #:# #:::::###=###=###  #::::::::##:::#   
        #::::#:##:# ###=#:#  #:# #:::::#:::# #:# ####=#########:::#   
        #::::#:##:#   #:#:#  #:# #:::::#:::# #:###:::::# ########=##  
   #######=###:##:#   #:=:#  #:# #:::::#:::# #:=:#:::::# #:::::::::#  
   #::::::::##:##:#####:###  #:# #######:::# #:#:#:::::# #:::::::::#  
   #::::::::#:::::::::#:#    #:#       #:::# #:=:#:::::# #:::::::::#  
   #::::::::#:::::::::=:#    #:#       #:::# #:###:::::# #:::::::::#  
   #::::::::#:::::::::#:#    #:#########=### #:# #:::::# #:::::::::#  
   #::::::::#:::::::::=:#    #:##::::::::::# #:# #:::::# #:::::::::#  
   #::::::::#:::::::::#:######:##::::::::::# #:# #:::::# #:::::::::#  
   #::::::::######=####::::::::##::::::::::###=###==#=#####=########  
   #::::::::#    #::::###########::::::::::=::::::::::# #::::::::::#  
   ##########    ######         ################:###### #::::::::::#  
                                      #::::::::::#      #::::::::::#  
                                      ############      ############  
