                                                                      
                                           ###############     #####  
                                           #:::::::::::::#     #:::#  
                                           #:###########=#######:::#  
                                           #:#   #:#   #:=:::::::::#  
                                           #:#   #:# ###:#####=#####  
                                           #:#   #:# #:::# #:#:::#:#  
     ###                                   #:#   #:# #:#:# #:#:::#:#  
   ###:#                    ############   #:#   #:# #:#:# #:#:::#:#  
   #:#:######################::::::::::#   #:#   #=# #:#:###:#:::#=#  
   #:#:=:::::::::::::::::::::::::::::::#   #:#   #:# #:#:#:#:#:::=:#  
   #:#:####################=#::::::::::#   ##### #:# #:#:#:#:#:::#:#  
   #:#:######             #:#::::::::::#     #:# #:# #:#:#:#:=:::#:#  
 ###:#:#::::#             #:#::::::::::#     #:# #:# ###:=:#:#:::#:#  
 #:#:#:=::::#             #:#::::::::::#     #:# #:#####=#:#:#:::#:#  
 #:#:#:#::::#             #:############ #####:# #:=:::::#:#:#####:#  
 #:#:#:#::::#             ###            #:::#:# #:#:::::#:#:#   #:#  
 #:#:#:#::::#           ##################:::=:# #:#:::::=:#:#   #:#  
 #:=:#:######           #:::=::::::::::::#:::#####:#####:#:#:#   #:#  
 ###:#=##################:###=############:::#:::#:# #:::::::#   #:#  
 ###:#::::::::::::::::=:::::::::::::#    #:::=:::#:# #:#####:#####:#  
 #:#:#:##################=#########=######:::#:::#:# #:# ###:::::::#  
 #:#:=:#     ###  #::::::::#  #:::=::::::=:::#####:# #:# #:#:#######  
 #:=:#:#     #:#  #::::::::####=###:####:#:#######=###:###:#:#        
 ###:#:#     #:#  #::::::::#:::::#::::::::::::=::::::::::=:#:#        
   #:#:#     #:#  #::::::::#:::::#==########=####=######=###=###      
   #:=:# #####=#############:::::#::::#  #::::::::::#  #:::::::#      
   #:#:# #:::::::::::::::::=:::::#::::#  #::::::::::#  #:::::::#      
   #=##################=##########::::#  #::::::::::#  #:::::::#      
   #::::::::::#########:#        #::::#  #::::::::::#  #:::::::#      
   #############:::::##:#        #::::#  #::::::::::#  #:::::::#      
             ###=###=##:### ###  #::::#  #::::::::::#  #:::::::#      
             #::::::::=:=:# #:#  #::::#  #::::::::::#  #:::::::#      
             #:########:#:# #:#  #::::# ##:#:########  #:::::::#      
             #:#  #:::::::# #:#  #::::# #::::################:######  
             #:#  #####:#####:#  #::::# #######:::::::::=::::::::::#  
             #:#      #:::::::#  ###:##########:#########::::::::::#  
             ###      #:::::###    #::::::::::::::::#   #::::::::::#  
                      #:::::#      ##################   #::::::::::#  
                      #######                           ############  
