                                                           #########  
              ####################     #####################:::::::#  
              #::::::::::::::::::#     #::::::=::::::::::=:#:::::::#  
              #=###################    ####:####=:##:#####:#:::::::#  
###############:::::::::::::::::::#       #::::::::::::::#:=:::::::#  
#::::::::::::####################=#  #########=###:#####=#:####:####  
############=##                 #:#  #:::::::::###:#   #:::#  #:####  
         #::::#         #########:#  #:::::::::=:#:#   #:#:#  #:##:#  
         ####:######### #:::::::=:#  #:::::::::::#:#   #:#:#  #:##:#  
          #:::::::::::# #########:####:::::::::#:#:#   #:#:#  #:##:#  
          #:#########:###########=##:=:::::::::#:#:#   #:::#  #:##:#  
          #:#      #:::::::::::::::::#=######=:#:#:#   #:#:#  #:##:#  
      #####=###   #####=##:#########:::#   #:::#=#:#####:#:#  #:##=#  
      #:::::::#   #:# #::::#       #:#:### #:::#:::::::#:#:####:##:#  
      #:::::::#   #:###=############:#:::# #:::#########:=:#:#####:#  
      #:::::::#   #:#:::#  #:::::::::#:#:# #:::#       #:#:#:###:#:#  
      #:::::::#   #:#:::#  #:::::::::#:#:# #:::#       #:::#:::=:#:#  
      #=######### #:#:::#  #:::::::::#:=:# #:::#       #:#:#=#:#:#:#  
      #:::::::::###:#:::#  #:::::::::#:### #############:::::::#:#:#  
      #:::::::::=:=:#:::#  ###########:#    #::::::::::###:###:#:#:#  
      #:::::::::#:#:##################:# ####:########## #:# #:=:=:#  
      #:::::::::#:#:#   #::::::::::::=:# #:::::::::#     #:# #:#####  
      #:::::::::#:#:#####:############:###########=##### #:# #:#:::#  
      #:::::::::#:#:=::::::::::::::::::::::#     #:::::# #:# #:#=###  
      #:::::::::#:########=###########:#:::#     #####:# #:# #:::=:#  
      #:::::::::#:#      #:::::::::::::::::#         #:# #:# #:#:#:#  
      #:::::::::#:#      #####=#########:::#         #:# #####:#:#:#  
      #:::::::::::#        #:::::::::# #:::#         #:# #:::#:#:#:#  
   #####=########=##       #:::::::::# #:::#   #######:###:::#:#:#:#  
   #:::::::::# #:::#       #:::::::::# #:::#   #:::::::::::::=:#:#:#  
   #:::::::::# #:::#       #:::::::::# #:::#   #:::::::::#:::#:#:###  
   #:::::::::# #:::#       #:::::::::###########:::::::::#:::=:#:#    
   #:::::::::# #####       #:::::::::##::::::::#:::::::::#:::###:#    
   #:::::::::#             #:::::::::##::::::::#:::::::::###=###:#    
   #:::::::::#             #######=####::::::::#:::::::::# #:::::#    
   #####=#############      #:::::::::#::::::::#:::::::::####=####    
       #:::::::::::::#      #:::::::::#::::::::#########=#:::::#      
       ###############      #:::::::::=::::::::#   #:::::#:::::#      
                            ###########::::::::#   #######:::::#      
                                      ##########         #######      
