        ###  ###    #################                                 
        #:#  #:#    #:::::::::::::::# ##########                      
        #:#  #:#    #=#######:::::::# #::::::::#                      
      ###:#  #:#    #:#     #:::::::###=########     #####            
      #:#:#  #:#    #:#     #:::::::#::::::::#       #:::#            
      #:#:#  #:#    #:#     #:::::::#::::::::#########:::#            
      #:#:#  #:#    #:#######::::::::::::::::#:::::::=:::#            
###   #:#:#  #:#    #:##::::#########::::::::=:::::::#:::#            
#:#   #:#:#  #:#  ###:#####=#       #::::::::#:::::::#:::#            
#:#   #:#:#  #:#  #:#:#   #:#       #######:##:::::::#:::#            
#:#   #:#:#  #:#  #:#:#   #:######    #::::::#:::::::#:::#######      
#:### #:#:#  #:#  #:#:#   #:=::::#    #::::::#:::::::#:::#:::::#      
#:#:# #:#:#  #:#  #:#:#   ###=#=### ###::::::#########:::#:::::#      
#:#:# #:#:#  #:#  #:#:#     #:::::# #:#::::::#  ##########:::::#      
#:#:# #:#:#  #:####:#:#   ###:#:::# #:#::::::#  #:::::#  #:::::#      
#:#:# #:::#  #:##:::#:#   #:::#:::# #:=::::::#  #####:####:::::#      
#:=:###:###  #:##:#:#:#   #:#:##### ###::::::#      #::::=:::::#      
###:#:::#    #:##:#:#:#   #:#:#       #::::::#      #::::#:::::#      
  #:#:#:#    #:##:#:#:#   #:#:#       ########      #::::#:::::#      
  #:=:::#    #:##:#:::#   #:#:####################  #::::#######      
  ###:########:##:#:###   #:#:=::::::::::::::::::#  #::::############ 
    #:#::::::#:##:#=#######:#=#######################::::=::::::::::# 
    #:#::::::#:##:=::::::::::::::=::::::::::::::::::=::::############ 
    #:#::::::::####=##################################=############## 
    #:=::::::=:#  #:###########################      #:::::=::::::::# 
    #:####=########:=:::::::::::::::::::::::::#      ################ 
    #:#  #::::::::#:###################:##=########################   
    #:#  #::::::::#:#       #:::::::::=:::::::::::::::::::::::::::#   
    #:#  #::::::::#:####### #############=######################=#### 
  ###:#  #::::::::=:=:::::#   #::::::::##::::::#      #:::::::::::::# 
  #:=:#  #::::::::#:####==#####=#########::::::#      #:############# 
  #:#:#  #::::::::#:::::::::::::::#     #::::::#      #:::#::::::#    
  #:#:#  #::::::::############=##############=## ######:###=######    
  #:#:#  #::::::::#          #::::::::::#:::::#  #::::::::::::::#     
  #:=:#  #::::::::#          ########:###=########:###########=###### 
  #:######=##=######                #:::::::::::::::::#      #::::::# 
  #:# #::::##::::::#                ##=###########=####      #::::::# 
  #:# ###########==##########        #:::::::::::::#         #::::::# 
  #:#           #:::::::::::#        ###############         ######## 
  ###           #############                                         
