                       ###################        ########     ###    
                       #:::::::::::::::::#        #::::::#     #:#    
                    ####:#####=#########:##########==###=##### #:#    
                    #::::::::::::::::::::::#::::::=::::::::::# #:#    
                ######:########:##=###=###=########=#=######## #:#    
                #:::##::::::::::##:::::::::::::::#:::::# #######:###  
              ###=#:###########=###=###=########:#::##:###:::::::::#  
              #:::::::::::::::::::=::::::::::::::::::::::::::::::::#  
         #########=#####=############:####=###=#=#########:::::::::#  
         #:=:::::::#   #:###########:::::::# #:#:#     #:=:::::::::#  
         #:###:=####   #:=:::::::::=:::::::# #:#:#     #:#:::::::::#  
         #:# #:::#   ###:###=#######:::::::# #:#:#     #:=:::::::::#  
         #:# #:::#   #:#:# #:# ########:######:#:#################=#  
         #:# #:::#   #:#:# #:###::::::::#::::::#:#:::::::::::::::::#  
         #:###:::#   #:::# #:=:#::::::::#::::#:=:#=#=##::###########  
         #:#:=:::#   ###:# #:#:#::::::::=::::#:#:::::::::=:########## 
         #:#:#:::#     #:# #:#:#::::::::#::::::#:#########:#::::::::# 
         #:#:#:::#     #:# ###:#::::::::=::::#:#:#       #:=::::::::# 
         #:#:#:::#     #:#   #::::::::::######:::#       #:#::::::::# 
         #:#:#=:########:#   ###::::::::#    #:#:#       #:#::::::::# 
         #:#:#:::::::::#:##### #::::::::#    #:::#     ###:#::::::::# 
         #:#:#:::::::::#:::::# #::::::::#    ###:#     #:#:####=##### 
         #:#:#:::::::::#:##### #::::::::#      #:#   ###:#:##::::#    
         #:#:#:::::::::#:#     ###=######      #:#   #:=:#:##::::###  
         #:#:#:::::::::::#       #:#############:#####:=:#:##::::=:#  
         #:#:###########:###     #:::::::::::::=:::::::#:#:##::::#:#  
         #:=:##::::::::::::#     #:#############==##=###:#:##::::=:#  
         #:####:#::::::::::#     #:#  #:::::::::::##:::#:=:##::::###  
    ######=## #:=::::::::::#     #:#  ##############:::###:##:##:#    
    #:::::::# ###::::::::::#     #:#               #:::# #:##::::#    
    #:::::::#  ###=#########     #:#               #:::# #:#######    
    #:::::::#  #:::::#############:#               #:::# #:#          
    #:::::::#  #:::::#::::::::::##:#               ##### #:#####      
    #########  #:::::#::::::::::##:#           ###########=#:::#      
               #:::::=::::::::::##:#############:::::::::::::::#      
               #:::::#::::::::::##:=::::::::::##:###########:::#      
#########################:#=######:#############:#         #####      
#:::::::::::::::::::::::::::#    ###           #=######               
#############################                  #::::::#               
                                               ########               
