                                                #############         
                                ###        ###  #:::::::::::#         
                         ########:#        #:#  #:########=#######    
###                      #:::::##:#        #:#  #:#::::# #:::::::#    
#:#                 ##########=##:#        #:#  #:#::::# #########    
#:#                 #::::::::::##:#        #:#  #:=::::#      #####   
#:#                 #::::::::::##:##########:#  #:#::::#      #:::#   
#:#                 #::::::::::##:=:::::::##:#  #:######     ##=#=### 
#:#                 #::::::::::##:##########:#  #:#          #::::::# 
#:################  #::::::::::##:###      #:#  #:#          #::::::# 
#:##:::::::::::::#  #::::::::::##:#:#    ###:#  #:#          #::::::# 
#:####:#########=####::::::::::##:#:#    #:::#  #:############::::::# 
#:=::::#      #:::::#::::::::::##:#:#    #:#:####:#:::::::::::::::::# 
###############:::::#::::::::::##:#:#    #:#:=:##:#:::::::::::::::::# 
        #:::::#:::::=::::::::::##:#:#    #:#:#:##:#::::::::::######:# 
 ########=###=#:::::#############:#:#    #:#:#:##:=::::::::::######:# 
 #::::::::###:=:::::#  ##########:#:#    #:#:#:##:######:#####::::::# 
 #::::::::#:::#:#:#:#  #::::::::#:::#    #:#:#:##:#  #::::::#######:# 
 #::::::::#:#:#:::::#  ########=#=###    #:#:#:##:#  #::::::#     #:# 
 #::::::::#:#:#:::::#    #:::::::::#     #:#:#:##:####::::::#######:# 
 #::::::::#=#:=:::::#  ###:::::::::###   #:#:#:##:##::::::::=::::##:# 
 #::::::::#:#:#:::::#  #:#:::::::::=:#   #:#:#:##:##:#::::::#=##:##:# 
 #::::::::#:#:#:::::#  #:=:::::::::#:#   #:#=#:##:##:########:::::=:# 
###=###=###:#:#:::::#  #:#:::::::::#:#   #:#:::##:##:########=####### 
#:::::::# #:#:####:=####:#:::::::::#:#   #:#:::##:##:=::::::::::#     
#:####### #:::#  #:::::#:#:::::::::=:#   #:#:####:####=##########     
#:#       ###:########:#:#:::::::::###   #:#:#  #::::::::#            
#:#         #:=::::::::#:####:#:############:####:#::::::#            
#:# ###########::::::::#:#  #::::::::::::#::::::::#::::::#            
#:# #::::::::::::::::::=:#  ##############::::::#:#::::::#########    
#######=########=###=###=#################::::::#=#::::::#:::::::#    
#::::::::::::::::=::::##:::::::::::::::::=::::::=:=::::::#:::::::#    
#######::::::::::#::::#####=##############::::::#:#::::::=:::::::#    
      #::::::::::#::::# #::::::::#########::::::#:=::::::#:::::::#    
     #############::::# #::::::::#::::::##::::::#:#::::::#########    
     #:::::::::::=::::# #::::::::#::::::##::::::::######:#########    
######:#########=#=######::::::::#::::::##::::::#:###  #:::::::::#    
#::::::::::::::::=::::::=::::::::=::::::#########:::#  ###########    
#########################::::::::########       #####                 
                        ##########                                    
