       #############                 #############   #############    
       #:::::::::::#                 #:::::::::::#   #:::::::::#:#    
       ###########=#######################=#####=##  #:#:::::::#:#    
             #::::::::::::=::::::::::::::::::=::::#  #:#:::::::#:#    
             ###:#=###########=########=##=#=#::::####=#########:#    
             #:=:::::::::::::::::::#  #:##:=:#::::=::::#     #:#:#    
             #:#####=########=##:#:####:##::::::::####=#######:#:#    
             #:#  #:::##:::::::::=:##:=:##:#:#::::#  #:::::::=:=:#    
             #:####:::###::###=###:##:#:##:#:#############=###=###    
             #:=:##:::# #::::::# #:##:=:##:#:#    #::::::::=:::#####  
           ###:#:##:::# #####=## #:####:##:#:# #################:::#  
         ###:=:#:##:::#     #:#  #:#  #:##:=:# #::::::::::::::##:::#  
         #:=:#:#:##:::#     #:#  #:#  #:####:# ##############=##:::#  
         #:#:#:#:##:::#     #:#  #:####=####=##############::::#:::#  
         #:#:#:#:##:::#     #:#  #:#::::::::::::::::::::::=::::#:::#  
         #:#:=:#:####=#########  #:#:::::::::#######:######::::::::#  
         #:#:#:#:#  #:::::::######:#:::::::::##:=::::#    #::::#:::#  
         #:#:#:#:#  #:::::::#:::##:#:::::::::##:#::::#  ###::::#####  
         #:#:#:#:#  #:::::::#:::##:::::::::::##:#::::#  #:=::::#      
         #:#:::#:#  #:::::::::::##:#:::::::::##:#::::####:#::::#      
         #:###:#:#  #:::::::#:::##:#:::::::::##:######:##:###=##      
         #:# #:#:# ##########:::##:#:::::::::##:#    #:##:# #:#       
         #:# #:#:###::::#####:::##:=:::::::::##:#    #:##:# #:#       
  ########=# #:#:=:#::::##:#######=#:::::::::##:#    #:##:# #:#       
  #::::::::# ###:#:=::::##:#:=:::::##:#########:#  ###:##:# #:#       
  ##########   #:#:#::::##:#:#=#:####:#   ##########:::##:# #:#       
               #:#:#::::##:#:#::::# #:#   #::::# #:#:=:##:# #:#       
  ############ #:::#::::##:#:#::::# #:#####=##=###:#:####:# #:#       
  #::::::::::# #:###::::##:#:#::::# #:#::::::::::=:=:#  #:# #:#       
  ##########=###:###::::##:#:#::::# #:#::::::::::#=###  #:# #:#       
          #:::::::##::::##:=:#::::# #::::::::::::#:#    #:# #:#       
          #:::::::##########:#::::# #:#::::::::::::#   ######:#       
          #:::::::#        #:###### #:#::::::::::#:#   #:##:=:#       
          #:::::::#        #:#      #:#::::::::::#:#   #:##:#:######  
          #########        #:#      #:###=#=##==########:##:#:#::::#  
                           #:#      #:# #::::::::::::::::####::::::#  
                           #:#      #=#########:##########  #:#::::#  
                           #:#      #::::::::::::::::::#    #:#::::#  
                           #:#      ####################    ########  
                           ###                                        
