            #########   #################                             
  ###########:::::::#   #:#:::::::::::::#                             
  #:::::::=:#:####=##   #:#=######:######################             
  ##:######:::#  #:#    #:=:#    #::::::::::::::::::::::#             
   #:#    #:#:#  #:#    #:#:# ####::::::#################             
   #:######:#:#  #:#    #:#:# #:##::::::#                   ###       
 ###:##:#:=:#:#  #:#    #:#:# #:##=######                   #:#       
 #:#:##:#:#:#:#  #:#    #:#:# #:##:::#  #####     #####     #:#       
 #:#:##:#:#:#:#  #:#    #:#:###=####=####:::#######:::#     #:#       
 #:#:##:#:#:#:#  #:#    #:#:=:::::::::::=:::#:::::#:::#     #:#       
 #:#:##:#:#:#:#  #:#    #:###:########=##:::#:::::=:::#     #:#       
 #:#:##:=:=:#:#  #:#    ### #:#:::::::::#:::#:::::#:::#     #:#       
 #:#:##:#:#:#:#  #:#        #:#:::::::::#:::#:::::#:::#     #:#       
 #:#:##:#:#:#:#  #:#        #:#:::::::::#:::::::::#####     #:#       
 #:#:##:#:#:#:#  #:#        #:#:::::::::##:##:::::#         #:#       
 #:#:##:#:#:#:#  #:#        #:#:::::::::##:##:::::###########:#       
 #:#:##:#:#:=:#  #:#        #:#:::::::::##:##:::::=::::::::##:#       
 #:#:##:#:#:###  #:#        #:#:::::::::##:##==####:######=##:#       
 #:#:##:#=#=######:##########:############:##:::::::::::::::#:#       
 #:#:##:#:=:::::::::::::::::=:#       ####:###=##=#########=#:#       
 #:#:##:::###############=#####       #::::::#::::#       #:#:#       
 #:#:##:#:# #:=:::::::::=:#############::::::######     ###:#:#       
 #:####:::# #:#:::::::::#::::::::::::::::::::#          #:::#:#       
 #:#  ###:# #:#:::::::::=:##########=##::::::#          #:#:#:#       
 #:######=#####:::::::::#:######## #:##::::::#          #:#:#:#       
 #:=::::::::::=:::::::::#::::::::# #:##::::::#          #:#:=:#       
 #=#=##############::####::::::::# #:###=#=##########   #:#:###       
 #:#:##########  #:::::##::::::::# ###:=:#::::::::::#   #:#:#         
 #:#:#::::::::#  #:::::##::::::::### #:#:=::::::::::#   ###:#         
 #:#:=::::::::#  #:::::##::::::::::# #:=::::::::::::#######:#         
 #:::=::::::::#  #:::::##::::::::#:# #####::::::::::#:::::=:#         
 #####::::::::#  #:::::##::::::::#:#     #::::::::::::::::#:#         
  #####:###:=### #:::::##::::::::#:#     #::::::::::#:::::=:#     ### 
  #::::::#:::::# #:::::####:######:#     #######=####:::::#########:# 
  #::::::#:::::# #:::::#::::::#  #:#  ##########::::#:::::#:::::::=:# 
  #::::::#:::::# #::::::::::::#  #:#  #::::::::=::::#:::::#=#######:# 
  #::::::#:::::# #:::::#::::::#  #:#  ##########::::#:::::=:#     #:# 
  ##=#####:::::# #######::::::#  ###           #::::#######:#######:# 
   #:::::=:::::#       #::::::#                ######     #:::::::::# 
   #############       ########                           ########### 
