                                                           ########## 
                                             #########     #::::::::# 
                               ###           #:::::::#   ###::::::::# 
                               #:#           #:::::::#   #:=::::::::# 
                               #:#           #:::::::#   #:########## 
                               #:#############:::::::#   #:=::::::::# 
                 ###############:#:::::::::::=:::::::#   #:#::::::::# 
                 #:::::::::::=:#:#=##:#=##############   #:#::::::::# 
                 #############:#:::##:=:::::::#          #:#::::::::# 
                 #############:###:##:##:##=##############:########:# 
                 #:::::::::::=:# #:##:##::::#  #::::::::##:#      #:# 
                 #=###########:# #=##:#######  #::::::::##:#      #:# 
                 #:#         #:###:##:#  #######::::::::##=########:# 
                 #:#         #:=:::##:#  #:::::=::::::::#::::::::##:# 
                 #:#     #####=#:#:###########=#:::::::::::::::::##:# 
                 #:#     #:::::#:#:=:::::::::=::::::::::#::::::::#### 
                 #:#     #:::::#:#####=#######:#::::::::##########    
                 #:#     #:::::#:=:# #:# #####:##########             
                 #:#     #:::::#:#:###:# #:::#:#  ###############     
                 #:#     #:::::###:#:=:#####:#:#  #:::::::::::::#     
                 #:#     #:::::# ###:#:#:# #:=:#####=##########=##### 
                 #:#     ##:##:### #:#:#:# #:#:=:::::::=::::::::::::# 
    ########     #:#      #:##:::# #:#:=:# #:#:#####=################ 
    #::::::#     #:#      #:##:::###:#:### #:#:#  #::::# #####:::::#  
 ####:############=########:##:::::#:#:#   #:#:#  #::::# #:::=:::::#  
 #::::::::::::::::::::::::::##:::#:#:#:#   #:#:#  #::::# #=#=#:::::#  
 ###:#########=###############:::#:#:#:#   #:#:#  #::::# #:::#:::::#  
 #:::::::::##::::::::#       #:::=:#:#:#   #:#=#############=#######  
 #:::::::::##::::::::#      ##:#####:#:#   #:#:::::::::::::::::::#    
 #:::::::::##::::::::#      #::::# ###:#   #:#########:#:####=##:#    
 #:::::::::####=######      #::::#   #:#   #:#       #:=:#  #:##:#    
 #:::::::::# #:::::#        #::::#   #:#####:#       #:#:####:##:#    
 #:::::::::# #:::::#        ######   #:#:=:=:#     ###:#:##:=:##:#    
 ########### #:::::#  ################:#:#:#:#     #:::#:##:#:##:#    
             #:::::#  #::::::::::::::::#:#:#:#     #:#:#:##:#:##:#    
             #:::::#  ##################:=:#:#     #:#:#:##:####:#    
             #:::::#      ##############:###:#     #:=:#:##=## #:#    
             #######      #::::::=:::::=:# #:#     ###:#:=:::# #:#    
                          ##############:# ###       ###:##### ###    
                                       ###             ###            
