                                              ######         #####    
                           ############       #::::####   ####:::#    
     #######################::::::::::#       #=#:=##:#   #:##:::#    
     #::::::::::::::::=:::##::::::::::#       #:#:::#:#   #:##:::#    
     #=################=#=##::::::::::#       #:#:::=:#   #:##:::#    
     #::::::##::::::::=:::::::::::::::#       #:#:::###   #:##:::#    
     #::::::######=######:##::::::::::#       #:#:::#  ####:##:::#    
     #::::::# #::::::::##:##::::::::::#####   #:#:::#  #:::::::::#    
  ####:###### #::::::::##:##::::::::::#:::#   #:#####  #:::::#:::#    
  #::::#      #::::::::##:##::::::::::#=#######:########:::::#:::#    
  #::::#    ###::::::::##:##::::::::::=::::::::::::::::=:::::#:::#    
  #::::#    #:#::::::::##:###=#########:#####:#:###=#####:#:########  
  #::::#    #:#::::::::##:# #:#  #:::::::# #::::# #::::##:=::::::::#  
  #::::#    #::::::::::##:# #:#  #:::::::###::::# #=#:###:##########  
  #::::#    #=#::::::::##:###:#  #:::::::#:=::::# #:#:# #:#########   
  #::::#    #:#::::::::####:::#  #########:#::::# #:#:# #:##::::::#   
  #::::#    #:#::::::::#  #:#:#########  #:#::::# #:#:# #:##:######   
  ######    #:#############:=:#:::::::#  #:#::::# #:#:# #:#::::::#    
            #:#         #:=:=:=:::::::#  #:=::::# #:#:# #:#::::::#    
            #:#         #:###:#:::::::#  #####:=# #:#:# #:#::::::#    
            #:#         #:# #:#:::::::#     #:::# #:#:# #:#::::::###  
            #:#         #:# #:###=#######   #:::# ###:# #:#::::::::#  
            #:#         #:# #:# #:::::::#   #:::#########:#::::::#:#  
            #:#         #:# #:# #########   #:::=:::# #:#:#::::::#:#  
            #:#         #:# #:#   ###########:::::::# #:#:=::::::#:#  
            #:#         #:###=##  #:::::::::#:::=:::# #:###::::::#:#  
            #:#         #:##:::#  #########:###=#:::###=###::::::#:#  
            #:#         #:##:::#  #::::::=::::::=:::::::::####:###:#  
            ###         #:##:::###############:###=##:=##:##::::##:#  
        #################:##:::=:::#      #::::#:=:::::##:##::::##:#  
        #::::::=::::::::::##:::#:::#####  #::::#:#####:#####::::##:#  
  ####################:#####:::#:::=:::#  #::::#:##::::::# #::::##:#  
  #::::::::::::::::::::#   #:::#:::###:## #::::#:##::::::# #::::##:#  
  ######################   #:::#::::::::# #::::=:##::::::# #::::####  
                           #:::#:::###### ###=#####::::::# #::::#     
                           #=################:::::######## #::::#     
                           #:::::::::::::::#################::::#     
                        ##############:#####     #::::::::::::::#     
                        #::::::::::::::#         ################     
                        ################                              
