                                                                      
                                                                      
                                                                      
                                                                      
                                                                  ### 
                                                                  #:# 
                                                                ###:# 
                                    #########################   #:::# 
                                    #:::::::::::::::::::#:::#   #:#:# 
                                 ######################=#=#=#####:#:# 
                                 #:##:::::::::::::=:::::::::::::#:#:# 
   #################             #:########################:#:#:#:#:# 
   #:::::::::::::::#             #:###############   #::::::::#:#:#:# 
   #:###############    ######   #:#:::::##::::::#   #::::::::#:#:::# 
 ###:#                  #::::#   #:::::::##:######   #::::::::=:#:#=# 
 #:::#           ########=########:#:::::#:::#     ###::::::::#:=:::# 
 #:#:#           #:::::::::::=:::=:=:::::#:::##### #::::::::::#:#:#:# 
 #:#=#############:###########=###:#:::::=:::::::# #:##########:#:=:# 
 #:#:=:::::::::::::# #:::::::::# #:#:::::::::#:::# #:##########:#:### 
 #:#:############### #:::::::::###:#:::::#####:::# #:##::::::##:=:#   
 #:=:#               #:::::::::=:#:#:::::#####:::# ####==######:###   
 ###:#               #:::::::::::#:#:::::=:::#:::#   #::::::=:#:#     
   #:#           ### #:::::::::#:#:#:::::#########   #::::::#:=:##### 
   #=#####       #:# #:::::::::#:::###################::::::#:#:#:::# 
   #:::::#       #:# #:::::::::#:=:#    #:::::::::::::::::::#:#:=:::# 
   #:::::#     ###:# #:::::::::###=######=######=#####::::::#:=:#:::# 
   #:::::#     #:#:# #:::::::::##:::::::::#    #:#   #::::::#:#:=:::# 
   #:::::#     #:#:# #####:########:##:#:##### #:#   #::::::#:::=:::# 
   #:::::#     #:#:#    #:::::::#::::::#:::::# #:# ###:######:::#:::# 
   #:::::#     #:#:#    #:::::#:#::::::#####:# #:# #:::#    #:#=##### 
   #:::::#     #:::#    #:::::#:#::::::# #:::# ### #:::#### #:#:::#   
   #############=###    #######:#::::::# #####     #:::##:# #:#:::#   
        #:::::::::#           #:#::::::########    #:::##:# #:#:::#   
#################:########### #:#::::::=::::::#    #:::##:# #:#:::#   
#:::::::::::::=:::::::::::::# #:=::::::#::::::###########=###:#:::#   
###########################=###:#::::::#:::::::::::::::=:::##:::::#   
   #::::::::=:::::::::::::::::#:=::::::#::::::###########=#####:::#   
   ##########=#######################=#######:#########:::#   #####   
     #::::::::::=:::::::::::::::::::=::::::::::::::::######           
     #################################################                
