                                        ###                           
       ###                              #:#               ########### 
       #:#                      ###     #:#               #:::::::::# 
     ###:#                      #:# ### #:#               #:#######=# 
     #:#:#                 ###  #:# #:# #:#            ####:#     #:# 
     #:#:##########        #:#  #:###:# #:#      ###   #:##:#     #:# 
     #:#:#::::::::#        #:#  #:::#:# #:#      #:#   #:##:#     #:# 
     #:#:#::::::::#        #:#  ###:#:# #:#      #:#   #:####     #:# 
     #:#:#::::::::#     ####:######:#:# #:#      #:#   #:# ########:# 
###  #:#:#::::::::#     #:::::::::=:#:# #:#      #:#   #:# #::::::#:# 
#:#  #:=:#::::::::#################:#:# #:#      #:#   #:# #::::::#:# 
#:######:=::::::::##::::::::::::# #:=:# #:#      #:#   #:# #::::::#:# 
#:#:=:##:#::::::::#############:###:#####:########=#####:# #::::::#:# 
#:#:#:##:##########           #::::::::::::::::::::::::#:# #::::::#=# 
#:#:#:##:#      ########################=#######:#######:# #::::::=:# 
#:#:#:##:#      #::::::::::##::::::=::::::::::::::#    #:###:######:# 
#:#:#:##:########=########=######:##:##############    #:##::::#  #:# 
#:#:=:##:=:::::::::::# #:::::::::::::::::::#           #:##::::####:# 
#:#=#=####=##=######:###=#######=###=###################:##::::=:##:# 
#:#:=:#  #::::=::::=::::::::::::::::::::::::::::::::::##:##::::#:##:# 
#:::#:#  ###########:###################################:##::::#:##:# 
###:#:#         ####:#  ###################            #:##::::#:##:# 
  ###:#         #:##:#  #::::::##:::::::::#            #:##::::#:##:# 
    #:#         #:##:####:####=##::###=##:##############:##::::::##:# 
    #:#         #:##:##::::::::::::::::::::::::::::::::::##::::::##:# 
    #:#         #:##:####==#######=########=#######=##=#####=###:##:# 
    #:#         #:##:#::::::##:::::::::##::::::::::::::::::::=:#:##:# 
    #:#         #:##:#::::::##:::::::::###########==###:##=###:#:##:# 
    #:#  ########:##:#::::::##:::::::::#  #:::::::::#:::::::##:#:##:# 
    #:#  #::::::#:##:=::::::##:::::::::#  #:::::::::#:::::::##:#:##:# 
    #:####=######:####::::::##:::::::::#  #:::::::::#:::::::##:#:##=# 
    #:=::::::::##:######=#=###:::::::::#  #:::::::::#:::::::##:#:##:# 
    #:###########:#::::::::#########=###  #:::::::::#:::::::##:####:# 
    #:######### #:=::::::::##:::::::::#   #:::::::::#:::::::####  #:# 
    #:#:::::::# ###::::::::##:::::::::#   #:::::::::#:::::::#     ### 
    #:#:#####:######=########:::::::::#   #:::::::::######=#####      
    #:=::::=:::::::::#      #:::::::::#   #:::::::::#    #:::::#      
    ######=###:###########  #:::::::::#   #####=#=#=#######:####      
     #:::=:::::::::::::::#  #:::::::::#       #:::#:::::::::#         
     #####################  ###########       ###############         
