   ######################                                             
   #::::::::::::::::::::#                         ###                 
   #=###############=##=#                         #:#                 
   #:::::::::::::::::##:#######                   #:#                 
   ####################:=:::::#                   #:#                 
                      #:###########################:#                 
                      #:#     #:::::::::::::#::::##:#                 
                      #:#     #############=#::::##:#                 
                      #:#                 #:=::::##:############      
                  #####=###################:#::::##:##:::::::::#      
                  #:::::::::::::::::::::::::#######:##:::::::::#      
                  #################:#######=#######:##:::::::::#      
                                #::::::::::::::=:::::::::::::::#      
                                ##############:#######:::::::::#      
                                         #::::::::#  ##############   
                           ###############::::::::######::::::#:::#   
         #####             #:::::::::::::=::::::::##:::#::::::#:::#   
         #:::#             #:###########:####:==:###:#:#::::::#:::#   
  ########:#=###############:# #########:#  #::::# #:#:#::::::=:::#   
  #::::::::::::::::::::::::#:# #:::::::=:######### #:#:#::::::#:::#   
  ########:########=######=#:# #########:=:::#     #:=::::::::#####   
     #:::::=::::::::##:###:#:#         #:=:::# ### #:#:#::::::#       
     #######::::::::##:#:::#:# #########:#:::# #:# #:::#::::::#   ### 
           #::::::::##:#:#:#:# #::::::##:#:::# #:# ###:#::::::#   #:# 
           #::::::::##:=:#:#:###:####:##:#######:#   #:#::::::#   #:# 
           ###########:#:#:#:##:::::::##:#   #:#=#####=########## #:# 
               ###   #:#:::#:##:::::::##=#####:=::::::::::::# #:# #:# 
   #######     #:#   #:#:#:#:##::::::::::::::#:############## #:###:# 
   #:::::#     #:#   #:#:#=#:##:::::::#::::::#:#########      #:=:#:# 
 ###=##:##     #:#####=#:#:=:##:::::::#::::::=:##::::::########:#:=:# 
 #::::::#      #:=:::::::=:#:##:::::::#::::::#:##:#=##=##::::##:::### 
 #=#######################:#:##:::::::=::::::#::::::::::=::::##:###   
 #:=::::::::::::::::::::##:=:##:::::::######=############::::##=##### 
 #:###################=:##=#:##########:::::::#:::::::::#::::#::::::# 
 #:#       #:::::::::::::::#:#        #:::::::#=#########:::::::::::# 
 #:#    ####=##=#####:=#####:#        #:::::::#::::::::###:###::::::# 
 #:#    #::::::::::::::#   #:#        #:::::::=::::::::# #:::=::::::# 
 #:#    ################   #:#  #############:#::::::::# #####::::::# 
 ###                       ###  #:::::::::::::#::::::::#     #::::::# 
                                ########################     ######## 
