           ###################         ###                            
           #:::::::::::::::::# ###     #:#                            
           #################:# #:#######:#                            
                           #:# #:##::::::#          ###               
                           #:# #:#######:#          #:#               
                           #:# #:###   #:############:#########       
                ############:# #:#:#   #:=::::::::::#:=:::::::#       
                #:::::::::##:# #:#:#   #:####################=###     
                #:::::::::##:# #:#:#   #:# #::::::::::#     #:::#     
       ##########:::::::::##:# #:#:#   #:###:##########     #:::#     
       #:=::::::#:::::::::##:# #:#:# ###:#::::::::::#       #:::#     
       #:######=#:::::::::##:# #:#:# #:#:#:##################:::#     
       #:#    #:#:::::::::##:# #:::# #:#:=::::::::::::::::::::::#     
       #:#    #:=:::::::::##:#####=###:###=#########################  
  ######:######:::::::::::##:::::::::#:=:::##::::::::::#######:::::#  
  #::::::##:::::#:::::::::##=#:#####:#####:##::::::::::=:::::::::::#  
  ###:##:####=#:#:::::::::=:::::::::::::::::=::::::::::#######:::::#  
    #:::::# #:#:###=###############=#########::::::::::#  ####:::::#  
    #:::::# #:#:# #::::::::::#    #::::::::##::::::::::#  #:########  
    #:::::# #:#:# #::::::::::# ####::::::::##::::::::::#  #:#         
    #:::::# #:#:# #::::::::::# #:##::::::::##:#:###:#:### #:#         
    #:::::###:#:# ############ #:##::::::::##:::##::::::# #:#         
 #####=####:=:#:################:##::::::::##:::##::::#:# #:#         
 #:::::::##:#:#:=::::::::::::::::############:::##::::#:###:#         
 #:::::::##:#:#:##################          #:::##::::#:#:#:#         
 #:::::::##:#:#:#########################   #:::##::::::#:::#         
 #:::::::##:#:#::::::::::::::::#::::::::#   #:::##::::###:#######     
 #:::::::##:#:#:######:#######:#::::::::#   #:::####### #:##::::#     
 #:::::::##:#:#::::::::#     #:#::::::::#   #####       #:#####=##    
 #:::::::##:#:#:##############:#::::::::#################=####:::###  
 ######:###:#:::#   #::::::::=:#::::::::=:::::::=::::::::::::::::=:#  
 #:::::::##:=:::#   ##########:#::::::::#=#######:##:#########:::#:#  
 #:::::::######:#            #::::::::::=::::::::::::::::::# #:::#:#  
 #:::::::#    #:########     ###::::::::#####=###=#####::::# #:::#:#  
 #:::::::#    #:##:::::# #######::::::::#   #:# #:::::#::::###:::#:#  
 #:::::::#    #=######=###::::##::::::::#   #:###=###=######:=:::#:#  
 #########    #::::::::::=::::###########   #:=:::::::#    #:#:::#:#  
              #::::::::::#::::#             #:#########    #:#:::::#  
              #:::::::::::::::#             ###            #:=:::###  
              #################                            #######    
