                   ###                  ######                        
              ######:#                  #::::#           #####        
              #::::#:#                ######=#           #:::#        
            ###::::#:#                #:=::::#           #:::#        
            #:#::::::#     ############:####=#############:::#        
            #::::::###     #::::::::::::##:::::::::::::::::::#        
            #:#::::#       ############:##:###=#########=######       
            #:#::::#                  #:##:# #:::::::=::::::::#       
            #:#########################:##:# #########:##=###### ###  
            #:#  #::::::::::::::::::::#:####         #:##::::::# #:#  
            #:#  ###:#:##=###########=#:#            #:##::::::# #:#  
          ###:######::::#:#   ###   #:::#########    #:##::::::# #:#  
          #::::::::=::::#:#   #:#   #:#:#:::::::#    #:##::::::# #:#  
      ######::######::::#:#   #:# ###:#:#:::::::#    #:#######:###:#  
      #:::::::#    ####=#:#   #:###:=:#:=:::::::#    #:#     #:::#:#  
      #:::::::#       #:::#   #:=:#:#:=:#########    #:####  #####:#  
      #:::::::#       #:#:# ###:#:#:#:################:##:#      #:#  
      #:::::::#       #:#:# #:#:#:#:#:#  #:::::::::::::##:#  #####:#  
      #:::::::#       #:#:# #:#:#:#:#:####=###########:##:#  #:::::#  
      #:::::::#       #:#:# #:#:#:#:#::::::####      #:##:####:#:###  
      #########       #:#:# #:#:::=:#:#:#####:#      #:##:=::::::#    
                      #:#:# #:#:###:#:#:# ###:########=####:###=:###  
                      #:=:# #:#:# #:=:#:###:#:#:::::::::::=::::::::#  
        ###############:### #:#:###:#:::=:#:#:#=##=#####=##::::::::#  
        #:::::::::::::::#   #:=:::::#=#:#:#:#:=::::::::::##::::::::#  
##################=##############=#:#:=:#:#:=:#####=#:##=##::::::::#  
#::::::::::::::::::# #::::::::::::#:#:#:=:###:#   #::::::##::::::::#  
#####=##########=##########=##=####:#:#:#=###:#############::::::::#  
#::::::#      #::::::#  #::::::#  #:#:#:#::::::::#        #::::::::#  
#::::::#      #::::::#  ########  #:#:=:#::::::::#######  #::::::::#  
#::::::#      #::::::#            #:###:=::::::::=:::::#  #::::::::#  
#::::::#     ######=###############:# #:#::::::::#:::::#  #=########  
#::::::#     #::::::#:=:::::::::::::# #:#::::::::#:::::#  #:::::::#   
#::::::#     ########:############### #:#::::::::#######  #:::::::#   
#::::::#            #:#               #:=::::::::#        #:::::::#   
########           ####################:#::::::::#        #:::::::#   
                   #::::::::::::::::=:::#::::::::#        #:::::::#   
                   #####=#==#############::::::::#        #:::::::#   
                       #::::#           ##########        #########   
                       ######                                         
