                          ###                     ###  ###########    
                          #:#                     #:#  #:::::::::#    
                          #:#                     #:#  ####=######    
                          #:#    ###############  #:#     #:#         
                          #:#    #:::::::::::::#  #=#     #:#         
                          #:######=###########=#  #:# #####:#         
                          #:#::::::=:::::::::=:#  #:# #:::#:#         
                          #:#::::::###########:#  #:###:=:#:#         
                          #:#::::::#         #:#  #:#:=:#:#:#         
                          #:#::::::#   #######=#  #:#:::=:=:#         
                          #:#::::::#   #:::::::#  #:#:###:#=#######   
                          #:#::::::#   #########  #:#:# #:::::::::#   
                          #:=::::::#      #########:#:# ###########   
                          #:#::::::#      #:::::::=:#:#               
 ##################       #:#::::::########=####=:#:#:######          
 #::::::::::::::::#       #:=::::::=::::::::::::::::#:=::::#          
 #############=##=#########:####::##:#:####:::::::###:######          
         #::::::::::::::::=::::::::::#:#  #:::::::=:#:#               
  ##############=#####:#######=:######:#  #:::::::#:::#               
  #:::::::::::::::::::::::::::::::#  #:#  #####=###:=:#               
  #:########:#=###:###########:##:#  #:#    ###:# #:###     ########  
  #:###### #:::##:::::### #:::::#:#  #:###  #:::# ###       #::::::#  
  #:#::::# ######:::::=:# #:::::#:####:=:#  #:#:#############=######  
  #:#::::#      #:::::#:# #:::::#:#:##:#:#  #:#:=::::=:::::::::#      
  #:=::::#      #:::::#:# #:::::#:#:##:#:#  #:#:#=##:#:::::::::#      
  #:#::::#      #:::::#:# #:::::#:#:##:#:#  #:#:#::::#:::::::::#      
  #:#::::#      #:::::#:###=#####:#:##:#:#  #:#::::::=:::::::::#      
  #:#::::#      #:::::#:#:::#   #:#:##:#:#  #:#::::::::::::::::#      
  #:####=####   #:::::#:=:::# ###==:##:#:#  #:#:=::::=:::::::::#      
  #:##::::::#####:::::###:::# #:::::##:=:#  #:#:##=######=######      
  #:##::::::=:::#####=####=###############  #:=:##::::::::::::#       
  ####::::::#:::#  #::::::::::#::::::########=#:#############:#       
     #::::::#:::#  #::::::::::#=#######:::::::#:###########:::###     
     #::::::#:::#  #::::::::::=:::#   #:::::::=:=:::::::::#:::=:###   
     #::::::#:::#  #::::::::::#####   #:::::::###:::::::::::::#:::#   
     #::::::#==##  #::::::::::#       #:::::::# #:::::::::::::#:#:#   
 ######=#####:::#  ############       #:::::::# ###########:::#:#:#   
 #::::::#   #:::#  ########################:###################:::#   
 ########   #:::#  #:::::::::::::::::::::::::::::::::::::::#  #####   
            #####  #########################################          
