     #####################                                            
     #:::::::::::::::::::#                                            
     ###################=#                                            
                       #:#                      #####  ###            
                       #:#                      #:::#  #:#            
                       #:#                      #:#:#  #:#       ###  
  ######################:#                      #:#:#  #:#       #:#  
  #:::::::::::::::::::##:#                    ###:#=####:#       #:#  
  ###################=##:#    ##############  #:#:=::::::#       #:#  
                    #:##:#    #:::::#::::::#  #:#:######:#       #:#  
                #####:##:#    #:::::#::::::#  #:::#    #:#       #:#  
          ##### #:::=:##:######:::::=::::::#  #:#:######:######  #:#  
          #:::# #####:##:=::::=:::::#::::::####:=:=:::::::::::#  #:#  
###########:#=#######:##::::::#:::::#####:###:#:#:################:#  
#:=::::=::::::::::::=:##:#::::#######  #::::=:#:#::::::::::::::::=:#  
#:#=####=############:##:#::::###      #=####:#:##=###:#############  
#:#:#  #:::::########:##:######:#      #:#  #:=:##:::::::::#          
#:#:#  ########::::=:::=:#    #:#      #:#  #:#=##:##:####:#####      
#:#:#       ##########:#:#    #:#      #:#  #:=::::::::::::::::#      
#:#:####    #::::::::::#:#  ###:########:#  #:#:################      
#:#:##:#    #::::::::::#:#  #::::::=:::=:#  #:::########              
#:#:##:#    #::::::::::#:####=###:##=#:::#  #:#:=::::::#              
#:#:##:#    #::::::::::#:=:::::::::#:#:=:#  #:#:#::::::#              
#:#:##:#    ##############:::::::::#:#:#:####:#:#::::::#              
#:#:##:#  ################:::::::::#:#:#:::##:#:#::::::#              
#:#:##:#  #::::::::::::::::::::::::#:#:######:#:#::::::#######        
#:#:##:#  ################:::::::::#:#:#    #:#:#::::::=:::::#        
###:##=################  #:::::::::#:#:# ####=#:#########:=########   
  #:=:::::::::::::::::#  #:::::::::=:=:# #::::=:# #::::##:::::::::#   
###=#################=####:::::::::###=###=##=#####::::##########=#   
#:::::::::#:::::::::=::::::::::::::=::::::::::::::=::::#::::::#:::#   
#:::::::::#:#########:####:::::::::####:###########::::#::::::#:::#   
#:::::::::=:::::::::::#  ###########  #:#::::::#  #::::=::::::#:::#   
######:###################            #:#::::::#  #::::#::::::#:::#   
     #:::::::::::::::::::#            #:=::::::#  #::::#::::::#:::#   
     #####################            #:#::::::#  #::::#::::::::::#   
                                      ###::::::#  ###############:### 
                                        #::::::#                #:::# 
                                        #::::::#                ##### 
                                        ########                      
