                                       #############                  
                                       #:::::::::::#                  
       ####################            ###########=#                  
###    #::::::::::::::::::#                      #:#   ###            
#:#    #=##################                      #:#   #:#            
#:#    #:#                           ###         #:#   #:#            
#:#    #:#                           #:#         #:#   #:#            
#:#    #:#                           #:#     ### #:#   #:############ 
#:#    #:####################        #:#     #:###:#   #:#::::::::::# 
#:#    #:=::::::::::::::::::#        #:#     #:#:#:#   #:#::::::::::# 
#:#    #:##################:######## #:#     #:#:#:# ###:#::::::::::# 
#:#    #:#      #::::::::::::::::::# #:#     #:=:#:###:::#::::::::::# 
#:#    #:########:####################:###   ###:#:#:#:#::::::::::::# 
#:###  #:::::::::::::::::::::=:::#:::#:=:#     #:#:#:::#:############ 
#:#:#  #:#######################:#:::#:#:#######:#:#:###:#            
#:#:#  #:#                     #:#:::=:#:=:::::=:#:#:# #:#            
#:#:#  #:#                     #:=:::#####=#######:=:# #:#            
#:#:#  #:#######################:##### #:::#########:# #:#            
#:#:#  #:##::::::::::::::::::::#:#     #:::#:::::::=:# #:########     
#:#:#  #:########=#######=#::::#:#######:::#:::::::### #:#:##:::#     
#:#:#  #::::::::::::::::::=::::::=:::::::::#:::::::#   #:#:##:::#     
#:#:#  ####:######:########=####:###:###:::=:::::::#   #:=:##:::#     
#:#:#     #:::::::::::#   #:#  #:#:::# #####:::::::#   #:####:::#     
#=#:#     #############   #:#  #:#####     #########   #:#  #:::#     
#:#:#                     #:#  #=#######################=####:::#     
#:#:#                     #:#  #::::::::::::::::##::::::::::=:::#     
#:#:# #####################:####:##############=##::::::::::#=###     
#:#:# #:::::::::::::::::::=:::::::::::::::::::::::::::::::::#:#       
#:#=########:##########=########==#########=######::::::::::#:######  
#:#:=::::::::#       #:::# #::::::#     #:::#::::#::::::::::#:#::::#  
#:#:##########       #:::###:############:::=::::#::::::::::#:#::::#  
#:=:# ################:::##:::::::::::::=:::#::::#::::::::::#:#::::#  
##### #::::::::::::::#:::########=#####=#:::#::::#::::::::::=:=::::#  
      ##############=#:::#    #:::#   #:=:::###########=#=###=######  
                #::::=:::#    #:::#   #:#:::#      #::::::::::=:#     
            ######=###=###    #:::#   #:::::####   #::::::::::=:#     
            #::::::=:::#      #:::#######:####:#   #::::::::::#:#     
            ##:#########      ######::::::#  #:######:#########:#     
             #::::::::#            ########  #:=::::::#       ###     
             ##########                      ##########               
