                                                                      
                 #####                                                
                 #:::#                                                
               ###:#:##############                    ######         
               #::::::##:::::=::::#                    #::::#         
################:#######:##########                    #::::#         
#:::::::::::::::::#   #::::#                           #::::#         
#=#####:#:######### ######=#######                   ###::::#         
#:#:::::::#         #::::::::::::#                   #:#::::#         
#:#:::::::######### #######=####:##                  #::::::#         
#:#:::::::=:::::::#      #::::::::#     ######       #:######         
#:#:::::::#####=######   #::::::::#     #::::#       #:#              
#:#:::::::#   #::::::#   #::::::::#     #=####       #:#              
#:################:###   #::::::::#     #:#          #:#              
#:# #:::#  #:::::::#     #::::::::#     #:#          #:#              
#:# #:#### #########     #::::::::#     #:#   ########:#              
#:# #:##:#               #::::::::#######=#####::::::::#              
#:# #:##:#################::::::::##::::::::::#::::::=:#              
#=# #:##:#::::::::::::::::::::::::##::::::::::#::::::###              
#:# #:##:#=###########:######:###=##:::::::::::::::::#                
#:###=##:#:#### #:::::::::::::#::::#::::::::::#::::::#                
#:#::::#:#:##:# ######=####=###::::#::::::::::############            
#:#::::#:#:##:#    #:::#  #:# #::::=::::::::::#     #::::#            
#:#::::=:::##:#    #:::#  #:# #::::#::::::::::##########:#   ######## 
#:#::::###:##:#    #:::#  #:# ######::::::::::=::::::::::#   #::::::# 
#::::::# #:##:#    #:::#  #:###    #::::::::::#######=########::::::# 
#:#::::# #:##:######:::#  #:#:#    #::::::::::# #::::::::::::=::::::# 
#:#::::# #:##:##:::=:::#  #:=:# #######=#########=################### 
#:########=##:##########  #:#:# #::::##:::::::::::#       ###         
#:::::::::::=:#############:#:# ####=######=#######       #:#         
#:#:::::::::#:::::::::::::::::#  #::::::::::############  #:#         
#:=:::::::::=:########=###########::::::::::=::::::::::#  #:######### 
#:::::::::::#:###### #:::::::::::=::::::::::############  #:::::::::# 
###:::::::::#::::::# #:######==###::::::::::#   ###########:######### 
  #:::::::::######## #:::::::::# #::::::::::#   #:::::::::#:#         
  ######:#########   ########=#########:#=###############:#:#         
       #:::::::::#         #:::::#    #:::::::::::::::::::=:#         
############=#=#=######    #:::#:######:############=######:######### 
#:::::::::::::::::::::#    #:::=::::::::=::::::::::::#    #:::::::::# 
#######################    ###########################    ########### 
