                 ###
   ###############:#           ######################
   #:::::::=:::::=:#           #:::=::::::::::::::::############      
#########:###=####:#           ########=###########=##:::::::::#      
#::::::::::::::::::#             #::::::###########:##########:####   
#####::::::::::#:#:#             #:::::::::::::::##:#    #::::::::#   
    #::::::::::#:#:#             #::::::###########:#  ###::::::::#   
    ############:#:#             #::::::#         #:#  #:#::::::::#   
               #:#:#             #::::::#         #:#  #:#::::::::#   
################=#:################################:#  #:=::::::::#   
#:::::::::::::::::::::::::=::::::::::::::::=::::::#:#  #::::::::::#
#############:##:##########:###=######=##=:######=#:####=############ 
            #:##:::#      #:=::::::::=::::::::::::::::=:::::::::::::# 
            #:##:::########:#:####=###:#:##=#=#########=#######:##### 
            #:##:::=::::::#::::::::::::#::::::#   #:::::::::##:::#    
            #:##:::#::::::#:##########:###::#:#   #:::::::::##:::#    
            #:##:::#::::::#:###    #::::::::::#   #:::::::::##:::#    
            #:##:::#::::::#:=:#    #::::::::::#   #:::::::::######
            #:##:::#::::::#:#:######::::::::::#   #:::::::::#     ### 
            #:##:::########:#::::::#######:#=############=###     #:# 
            #:##:####     #=#:#::::#    #:::::::::::::::::#       #:# 
            #:#:::::#     #:=:#::::#    ######=########=###########:# 
            #:#:::::#     #:###::::#         #::::::::::::::::::=:#:# 
            #:#:::::#######:=:######################=::#=########:=:# 
            #:=:::::::::::#:#:####:=:::::::::::::::::::=:::#    #:### 
      ###   ###:::::#:::::###:##:#:#####################:::#    ###   
      #:#     #######:::::# #:##:#:#########  ########:=:::#          
      #:#           #:::::# #:##:#:#:::::::#  #:::::##:#=:#########   
      #:#           ####### #:##:#:#:::::::####=######:#::::::::=:#   
      #:#                   #:##:=:=:::::::=::::#::::#:##########:#   
     ##:########################:#:#:::::::=::::=::::#:#        #:#   
     #::::::::::::::::##:::::::::#:#:::::::#::::#::::###        #:#   
     ################:###=########:#::::::::::::#::::#          #:#   
        #:::::::::::::::::#      #:#:::::::######::::#########  ###   
        ###################      ###:::::::#    #::::::::::::#        
                                   #:::::::#    #::::#:::::::#        
                                   #:::::::#    #::::#:::::::#        
           ###########################=##########::::::::::::#        
           #:::::::::::::::::::::::::::=:::::::##::::#########        
           ###########################################                
