                 ###                              #######             
               ###:################      ##########:::=:#             
               #:#:##:::::::::::::#      #:::::::######:#             
               #:#:##=####################:::::::#  #:=:#    #####    
               #:#:##::::::::::::::::::::=:::::::####:#:#    #:::#    
               #:#:###########=#########=#:::::::##:=:#:#    #:###    
               #:=:=:::::::::::#       #:#:::::::##:#:#:#    #:#      
            ####:#:###########:#########:#:::::::##:#:#:#    #:#####  
            #::::#:#    #:::::::::::::##:#:::::::##:#:#:#    #:#:::#  
            ###=##:###  #=##########:###:##########:#:#:#    #:=:::#  
              #:##:=:#  #:#::::::#:::# #:#        #:#:::###  #:#:::#  
              #:##:#:#  #:=::::::#:::# #:#        #:#:#:#:#  #:#:::#  
              #:##:#:####:#::::::#:::# #:#        #:###:#:#  #:=:::#  
              #:##:=:##:::########:::# #:#        #:# #:#:####=#:###  
              #:##:#:##:#:#::::# ##### #:#        #:# #:#:#::::::###  
              #:##:=:##:::#=####       #:#        #:# #:=:#::::::=:#  
              #:##:#=####:=:#          #:#        ### #:#:=::::::#:#  
              #:##:#:#  #:#:############:#########    #=#:#::::::#:#  
              #:##:#:#  #:#:#:::=:::::##:#:::::::######:#:#####=##:#  
              ####:#:#  #:#:#:::#:::::##:#:########:::#:#:##::::##:#  
                 #=#:#  #:#:::::::::::##:=:# ######:###:::##::::##:#  
  ################:###  #:=:#####:::::##:#:# #::::::::=:#:##::::##:#  
  #::::::::::::::::#    #:::#   #:::::##:#:# #:########:#:##::::##:#  
  ################:#    #:###   ########:=:# #:::#    #:#:##::::##:#  
                 #:######:##############=#######:######:=:########:#  
                 #:=::::::::##:::::::::::::::::=::::::::#:#      #:#  
                 ##########:##=#####:###########::::::###:#####  ###  
               ###    #:::::::::# #::::::#     #::::::# #:::::#       
               #:#    #:::::::::# #::::::#     ##########:#:::#       
               #:#    #:::::::::# #::::::#     #::::# #:::=:::#       
               #:#    #:::::::::################:#### #########       
               #:#  ###:::::::::=::::::::::#:::::::################## 
               #:#  #:#:::::::::#:########=#:::::::=::::::::::::::::# 
               #:#  #:#:::::::::=::::::::::#:::::::##########:####### 
               #:#  #:#:::::::::#::::::::#:=:::::::#    #::::::::::#  
               #:#  #:#:::::::::#::::::::=:#:::::::#    #::::::::::#  
               #:#  #::::::::::::::::::::###:::::::#    #::::::::::#  
               #:###########=####::::::::# #########    #::::::::::#  
               #:=:::::::::::#  #::::::::#              ############  
               ###############  ##########                            
