                                                 ##############       
                     #########################   #:=::::::::::#       
                     #:=:::::::::::::::::=:::#   #:########=#####     
                     #:#=########=########:::### #:#     #::::::#     
                     #:#:########:########:::::# #:#     #::::::#     
                     #:#:=:::::##:::::::##:::#:###:#     #::::::#     
                   ###:#:#:###=##:#=######:::#:#:::#     #::::::#     
                   #:#:#:#::::::#:::#    #:::#:#:#:#######::::::###   
                   #:#:#::::::::#:#:# ########:#:#:#::::#########:#   
                   #:#:#:#::::::#:#:# #:######:#:=:#=##:#####   #:#   
                   #:#:#:########:#:# #:#:#:##:###:#::::::::#   #:#   
                   #:#:#:#    ###:#:###:#:#:##:# #:#::::::::#   #:#   
                   #:=:#:#    #:=:#:#:=:#:#:##:# #:=::::::::#   #:#   
                   ###:=:#    #:#:#:#:#:#:#:#### #:#######=######:#   
                    ####=##   #:#:#:#:#:=:#:#    #:#######::::::#:#   
                  ###:=:::#   #:#:#:#:#:#:#:#    #:#:::::########:#   
                  #:::#:::#####:#:#:#:#:#:#:#    #:::::::#      #=#   
                  #:#:#:::#:::#:=:#:#:#:#:#:###  #:#:::::#      #:#   
                  #:::#:::=:::###:#:#:#:#:::=:####:#######      #:### 
          #########=#:#:::#:::# #:#:#:#:#####:#::::#     ########:#:# 
          #:::::::::#:=:::##### #:#:#:#:#   #:#::::#     #:::::##:=:# 
          #############:::#     #:###:#:#   #::::::# #####=###:##=#:# 
 ######################:::#     #:# #:#:#   #:#::::# #::::::::::::::# 
 #::::::::::::::::::::::::#######=###:=:#   #:########::############# 
 ###=###:##########:#=##:###:::::::####:#   #:# #::::::::#::::::#     
   #::::::::::::::=::::::::#:::::::#  ###   #:# #::::::::=::::::#     
####=#########=####::::::::#:::::::#        #:# #::::::::#::::::#     
#::::::::::::::#  #::::::::=:::::::#        #:# #::::::::#::::::#     
#:###=##############::##:###:::::::##########:# #::::::::#::::::#     
#:##:::::=::::::::::::##:# #:::::::#::::::::#:# #::::::::#::::::#     
######=###:###=#########:# #:::::::#::::::::=:# #::::::::#::::::#     
   #:::::::# #:::#     #:# #:::::::#::::::::#=###::::::::#::::::#     
   ######### #####     ### #:::::::=::::::::#:::#::::::::#::::::#     
    #########################=######::::::::#::::::::::::=::::::#     
    #:::::::::::::::::::::::::#    #::::::::=:::####:#######=####     
    ################=####:#####    ##########:::::::::::::##:::#      
                   #::::::#                 #####:##########:::#      
                   ########                  #::::#        #:::#      
                                             ######        #:::#      
                                                           #####      
