_____________________________
__'00000000000000000000000"__
__>#######################<__
__*::!::::::::::::::::::::/__
__*:::::?:::::::::::::::::/__
__*:::::::::::::::::::::::/__
__*::@::::::::::::::::::::/__
__L#######################R__
_____________________________
_____________________________